11111111111111111111111111111111111111111111111111111111111111111111111111111111
10000000000000000000000000000000000000011000000000000000000000000000000000000001
10000000000000000000000000000C000000C00110000000000000000000000000000C0000000001
10000000000000000000000000C000000000C00110000000000000000000000000C0000000000001
10000000000000000000000000C000000000C00000000000000000000000000000C0000000000001
100000000000C0000000000000C000000000C000000000000000C0000000000000C0000000000001
1000000CCC0000000000000000C000000000C0000000000CCC0000000000000000C0000000000001
1000000CCC0011111111111111C11110000000000000000CCC0011111111111111C1111000000001
1000000CCC0011111111111111111110000000000000000CCC001111111111111111111000000001
1000000CCC0011111111111111111110000000000000000CCC001111111111111111111000000001
1000000CCC0011111111111111111110000000000000000CCC001111111111111111111000000001
10000000000011111111111111111110000000000000000000001111111111111111111000000001
1000000C00001111111111111111111000000C000000000C0000111111111111111111100000C001
1000000C00001111111111111111111000000C011000000C0000111111111111111111100000C001
1000000C00001111111111111111111000000C011000000C0000111111111111111111100000C001
1000000C00000000000000000000000000000C011000000C0000000000000000000000000000C001
1000000C00000000000000000000000000000C011000000C0000000000000000000000000000C001
10000000000000000000000000000000000000011000000000000000000000000000000000000001
1000000000000000000000000000000000000C01100000000000000000000000000000000000C001
11111100000000000000000000000000111111111111111111000000000000000000001111111111
11111100000000000000000000000000111111111111111111000000000000000000001111111111
100000000000000000EP000000000000000000011000000000000000000000000000000000000001
10000000000000000000000000000C000000C00110000000000000000000000000000C0000000001
10000000000000000000000000C000000000C00110000000000000000000000000C0000000000001
10000000000000000000000000C000000000C00000000000000000000000000000C0000000000001
100000000000C0000000000000C000000000C000000000000000C0000000000000C0000000000001
1000000CCC0000000000000000C000000000C0000000000CCC0000000000000000C0000000000001
1000000CCC0011111111111111C11110000000000000000CCC0011111111111111C1111000000001
1000000CCC0011111111111111111110000000000000000CCC001111111111111111111000000001
1000000CCC0011111111111111111110000000000000000CCC001111111111111111111000000001
1000000CCC0011111111111111111110000000000000000CCC001111111111111111111000000001
10000000000011111111111111111110000000000000000000001111111111111111111000000001
1000000C00001111111111111111111000000C000000000C0000111111111111111111100000C001
1000000C00001111111111111111111000000C011000000C0000111111111111111111100000C001
1000000C00001111111111111111111000000C011000000C0000111111111111111111100000C001
1000000C00000000000000000000000000000C011000000C0000000000000000000000000000C001
1000000C00000000000000000000000000000C011000000C0000000000000000000000000000C001
10000000000000000000000000000000000000011000000000000000000000000000000000000001
1000000000000000000000000000000000000C01100000000000000000000000000000000000C001
1000000C00000000000000000000000000000C011000000C0000000000000000000000000000C001
1000000C00000000000000000000000000000C011000000C0000000000000000000000000000C001
10000000000000000000000000000000000000011000000000000000000000000000000000000001
1000000000000000000000000000000000000C01100000000000000000000000000000000000C001
1000000C00000000000000000000000000000C011000000C0000000000000000000000000000C001
1000000C00000000000000000000000000000C011000000C0000000000000000000000000000C001
10000000000000000000000000000000000000011000000000000000000000000000000000000001
1000000000000000000000000000000000000C01100000000000000000000000000000000000C001
1000000C00000000000000000000000000000C011000000C0000000000000000000000000000C001
1000000C00000000000000000000000000000C011000000C0000000000000000000000000000C001
10000000000000000000000000000000000000011000000000000000000000000000000000000001
1000000000000000000000000000000000000C01100000000000000000000000000000000000C001
11111111111111111111111111111111111111111111111111111111111111111111111111111111
