1111111111111111111
10000000000000000C1
1000000000000000001
1000000C00000000001
1000000000000000001
1000000000C00000001
1000000000000000001
10000000P0000000001
10000000000000000E1
1111111111111111111