111111111111111111111111111111111111111111
1C0000000000001100011C00000000C00000000001
1P00C00110000011111110C0000000000000000001
1E00000000000000C000000C001111111000000001
1000011111100000001CCC00000111111100000C01
1000011111100000001CCC00000110011100000C01
1000011001100000001CCC00000110011100000C01
1000011001100000001CCC00000110011100000C01
1000011111100000001CCC00000111111100000C01
111111111111111111111111111111111111111111