1111111111111111111
1C000000000C0011111
1P00001111111111111
1E11111100000011111
1111111111111111111