111111111111111
1C0011000000001
1P0000111111111
1E1111110000001
111111111111111