1111111111111111111
1C000010000C0011111
1P00001000000011111
1E11111111111111111
1111111111111111111