1111111
10C0001
1E00PC1
10C0001
1111111