1111111
10C0C01
1EP00C1
10C001
1110111