1111111111111111111111111111111111111111
1000000000000000000000000000000000000001
10000000000000000000000000000C000000C001
1E000000000000000000000000C000000000C001
10000000000000000000000000C000000000C001
100000000000P0000000000000C000000000C001
1000000CCC0000000000000000C000000000C001
1000000CCC0011111111111111C1111000000001
1000000CCC001111111111111111111000000001
1000000CCC001111111111111111111000000001
1000000CCC001111111111111111111000000001
1000000000001111111111111111111000000001
1000000C00001111111111111111111000000C01
1000000C00001111111111111111111000000C01
1000000C00001111111111111111111000000C01
1000000C00000000000000000000000000000C01
1000000C00000000000000000000000000000C01
1000000000000000000000000000000000000001
1000000000000000000000000000000000000C01
1111111111111111111111111111111111111111
