1111111111111111111111111111111
1PCCCCCCCCCCCCCCCCCCCCCCCCCCCC1
1ECC111111111111111111111111CC1
1CCCCCCCCCCCCCCCCCCCCCCCCCC1CC1
1CCC111111111111111111111111CC1
1CCC1CCCCCCCCCCCCCCCCCCCCCCCCC1
1CCC111111111111111111111111CC1
1CCCCCCCCCCCCCCCCCCCCCCCCCC1CC1
1CCC111111111111111111111111CC1
1CCC1CCCCCCCCCCCCCCCCCCCCCCCCC1
1CCC111111111111111111111111CC1
1CCCCCCCCCCCCCCCCCCCCCCCCCC1CC1
1CCC111111111111111111111111CC1
1CCCCCCCCCCCCCCCCCCCCCCCCCCCCC1
1111111111111111111111111111111
