1111111
10C0C01
1EP00C1
10C0001
1111111